Bird Dropping Spider	(Celaenia excavata)			
Biting Jumping Spider	(Opisthoncus mordax)			
Black Wishbone Spider	(Aname atra)			
Bronze Jumping Spider	(Helpis sp)			
Brown Huntsman Spider	(Heteropoda jugulans)			
Brush-footed Trapdoor Spider	(Seqocrypta sp)			
Comb-footed Spider	(Chrysso sp)			
Crab Spider	(Sidymella sp)			
Daddy Long Legs Spider	(Pholcus phalangoides)			
Dew Drop Spider	(Argyrodes antipodianus)			
Dome Web Spider	(Cyrtophora moluccensis)			
Enamelled Spider	(Araneus bradleyi)			
Flower Spider	(Diaea sp)			
Flower Spider	(Zygometis lactea)			
Garden Orb Weaver Spider	(Eriophora sp)			
Garden Orb Weaver Spider	(Eriophora transmarina)			
Golden Orb Weaver Spider	(Nephila edulis)			
Golden Trapdoor Spider	(Arbanitis sp)			
Green huntsman	(near-Neosparassus undescribed)			
Green jumping spider	(Mopsus mormon)			
Grey House Spider	(Zosis geniculatus)			
Huntsman Spider	(Neosparassus sp)			
Jewelled Spider	(Gasteracantha minax)			
Jumping Spider	(Opisthoncus polyphemus)			
Jumping Spider	(Opisthoncus sp)			
Leaf-curling Spider	(Phonognatha sp)			
Long Jawed Spider	(Tetragnatha sp)			
Lynx Spider	(Oxyopes sp)			
Melbourne Trapdoor Spider	(Stanwellia grisea)			
Miagrammopes - unknown Spider species	(Miagrammopes sp2)			
Mouse Spider	(Missulena bradleyi)			
Net-casting Spider	(Deinopis subrufa)			
no common name	(Uloborus barbipes)			
Red House Spider	(Nesticodes rufipes)			
Red-headed Mouse Spider	(Missulena occatoria)			
Redback Spider	(Latrodectus hasselti)			
Sac Spider	(Clubiona sp)			
Sac Spider	(Cheiracanthium gilvum)			
Scorpion Tailed Spider	(Arachnura higginsi)			
Scrub Tick	(Ixodes holocyclus,)			
Silver Orb Weaver Spider	(Leucauge sp)			
Spider Mite	(Tetranychidae family )			
Spitting Spider	(Scytodes thoracica)			
Spotted Ground Spider	(Storena sp)			
St. Andrews Cross Spider	(Argiope keyserlingi)			
stick spider	(Miagrammopes sp)			
Sydney Brown Trapdoor Spider	(Misgolas rapax)			
Sydney Funnel-web Spider	(Atrax robustus)			
Tent Web Spider	(Cyrtophora hirta)			
Theridion spider - unknown species	(Argyrodes sp)			
Three-lobed Spider	(Cyclosa sp)			
Three-lobed Spider	(Cyclosa trilobita)			
Victorian Funnel-web Spider	(Hadronyche modesta)			
Wall Spider	(Oecobius sp)			
Water Spider	(Dolomedes sp)			
White Crab Spider	(Thomisus spectabilis)			
White Flower Spider	(Diaea sp2)			
White-tailed spider	(Lampona cylindrata)			
Wolf Spider	(Lycosa sp)
